NO ./textures/test_texture1
SO ./textures/test_texture2
WE ./textures/test_texture3
EA ./textures/test_texture4

F 220,100,0
C 225,30,0

1111111111111111111111111
1000000000110000000000001
1000100000110000010000001
1000000000000000000000001
1000001111111110000010001
1000000000000000000000001
1000000000000000000N00001
1111111111111111111111111
