NO ./textures/stone.xpm
SO ./textures/iron.xpm
WE ./textures/gold.xpm
EA ./textures/diamond.xpm

F 15,190,0
C 90,220,255

1111111111111111111111111
1E00000000000100000000001
1011111111101011111111101
1010000000101010000000101
1010111110101010111110101
1010100010100010100010101
1010101110111110111010101
1010101000001000001010101
1011101111101011110111101
1000000000001010000000001
1111111111111010111111111
1000000000000010000000001
1011111111111111111111101
1010000000000000000000101
1010111111111111111110101
1010000000000000000000101
1111111111111111111111111
