NO ./textures/pacman_wall.xpm
SO ./textures/pacman_wall.xpm
WE ./textures/pacman_wall.xpm
EA ./textures/pacman_wall.xpm

F 1,13,54
C 0,58,248


1111111111111111111111111111111
1111100000000000000000000011111
1111000000000001000000000001111
1110000000000011100000000000111
110000S000000111110000000000011
1110000000000011100000000000111
1111000000000001000000000001111
1111100000000000000000000011111
1111111111111111111111111111111
